16 16
++++++++++++++++
+ ++++++++++++++
       + +++++++
+ ++++ + +++++++
+ ++++ + +++++++
+ ++++         +
++++++++++++++ +
++++++++++++++ +
++++++++++++++ +
++++++++++++++ +
++++++++++++++ +
++++++++++++++ +
+     +++++++  +
+ +++ ++++++++ +
+ +             
++++++++++++++++