16 16
++++++++++++++++
+ ++++++++++++++
       + ++    +
+ ++++ + +  + ++
+ + ++ + ++++ ++
+ +            +
++++++++++++++ +
+  ++    +++   +
+ ++++++     +++
+          +++ +
+++++ ++++++++ +
+++++ ++       +
+   + ++ ++ ++ +
+ +++ ++++++++ +
+               
++++++++++++++++