16 16
++++++++++++++++
+ ++++++++++++++
       +++++++++
+ ++++ +++++++++
+ ++++ +++++++++
+ ++++         +
++++++++++++++ +
++++++++++++++ +
++++++++++++++ +
++++++++++++++ +
++++++++++++++ +
++++++++++++++ +
+     +++++++  +
+ +++ ++++++++ +
+ +             
++++++++++++++++